NO ./xpm/star_wars/star_wars_wall_north.xpm
SO ./xpm/star_wars/star_wars_wall_south.xpm
EA ./xpm/star_wars/star_wars_wall_east.xpm
WE ./xpm/star_wars/star_wars_wall_west.xpm

F 14,13,13
C 36,36,36

1111111111111111
1000000000000001
1000000000000001
1000000000000001
1000000S00000001
1000000000000001
1000000000000001
1000000000000001
1111111111111111
