NO ./xpm/wonderland_wall_north.xpm
SO ./xpm/wonderland_wall_south.xpm
WE ./xpm/wonderland_wall_west.xpm
EA ./xpm/wonderland_wall_east.xpm

F 179,144,96
C 159,228,245

111 11111
101110001
100100001
101001001
100000001
111S00001
  1111111
