NO ./xpm/wonderland_wall_north.xpm
SO ./xpm/wonderland_wall_south.xpm
WE ./xpm/wonderland_wall_west.xpm
EA ./xpm/wonderland_wall_east.xpm

F 179,144,96
C 159,228,245

11111111111111111111111111111111111111111
10100010000000001000000010000100010100011
10101010101111101111101010110101010001001
10101011101000100000101010110101010111101
10001000101010101000101010000100010000101
10111010101010101010001011110101011110101
10100010101110101000101010000001000010101
10111110100000100000101010111111111010101
10000010111111101111101000001000001000101
11111010000000001000001111101111001111101
10001010111111011011111000101000001000001
10100010100010100010000010101001111011111
10111110101010111110111110101000000000001
10000010001010101010100000101111001011111
11111011111010000000111110100001001110001
10000000001000101010010010101111001000001
10000000001111111111010010101000001001001
10000000001000000001011010001011101001001
10010001001111111101001010101010101000001
10000000000000001101101010111011101111101
10000000000011101000101000000000000000001
10010001001010001010101011101111011101111
10000000001010101010101110001000010000001
1000N000001010111010101011111011010111101
10000000001010000010101000001001010100001
11111111111011111110101011101111000101111
10000000000010000000101000100001000100001
10111111111110111111101110101011111111101
10101010101100001000001000101000000000001
10000000000110101010111001111111111111111
10010101010010101010000000000010000000001
10111111111010100011100000111010111111101
10001000000000000010101010101010100000001
11111111111110111110100000100010101111111
10000001000110100010101010101110101010101
10100100010000101010100000100000100000001
10001111111111100010101010111111110101011
10101000100010001000100000100010100000001
10000010101010100010101010101010110101011
10101010101010101010100000001010100000001
10001010001000100010100000101000101010101
11111111111111111111111111111111111111111