NO ./xpm/wonderland_wall_north.xpm
SO ./xpm/wonderland_wall_south.xpm
EA ./xpm/wonderland_wall_east.xpm
WE ./xpm/wonderland_wall_west.xpm
F 179,144,96
C 159,228,245

11111111111
10000000N01
10000000001
10000000001
10000000001
10000000001
11111111111
